1	1	1	1	1	1	1	1	1	1	1	1	1	1	1	1	1	1	1	1	1	1	1	1	1	1	1	1	1	1	1	1
0	0	0	0	0	0	0	0	0	0	0	0	0	0	0	0	0	0	0	0	0	0	0	0	0	0	0	0	0	0	0	0
0	0	0	0	0	0	0	0	0	0	0	0	0	0	0	0	0	0	0	0	0	0	0	0	0	0	0	0	0	0	0	0
0	0	3	0	0	0	0	0	0	0	0	0	0	0	0	0	0	0	0	0	0	0	0	0	0	0	0	0	0	0	0	0
1	1	1	1	1	1	4	1	1	1	1	1	4	1	1	1	4	1	1	1	1	1	5	1	1	1	1	1	1	1	1	1
0	0	0	0	0	0	4	0	0	0	0	1	4	0	0	0	4	0	0	0	1	0	5	0	0	0	0	0	0	0	0	0
0	0	0	0	0	0	4	0	0	0	0	1	4	0	0	0	4	0	0	0	1	0	5	0	0	0	0	0	0	0	0	0
1	1	1	5	1	1	1	1	1	4	1	1	1	1	1	1	1	1	5	1	1	1	1	1	1	1	4	1	5	1	1	1
0	0	0	5	0	0	0	0	1	4	0	0	0	0	0	0	0	0	5	0	0	0	1	0	0	0	4	1	5	0	0	0
0	0	0	5	0	0	0	0	1	4	0	0	0	3	0	0	0	0	5	0	0	0	1	0	3	0	4	1	5	0	0	0
1	1	1	1	1	1	4	1	1	1	1	5	1	1	1	1	1	1	1	1	4	1	1	1	1	1	4	1	1	1	1	1
1	0	0	0	0	0	4	0	0	0	1	5	0	0	0	0	1	0	0	0	4	0	0	0	0	1	4	0	0	0	0	1
1	0	0	0	0	0	4	0	0	0	1	5	0	0	0	0	1	0	0	0	4	0	0	0	0	1	4	0	0	0	0	1
1	1	1	1	4	1	1	1	4	1	1	1	1	5	1	1	1	1	4	1	1	1	1	1	1	1	1	1	4	1	1	1
0	0	0	0	4	0	1	0	4	0	0	0	0	5	0	0	0	0	4	0	0	0	0	0	0	1	0	0	4	0	0	0
0	0	0	0	4	0	1	0	4	0	0	0	0	5	0	0	0	0	4	0	0	0	0	0	0	1	0	0	4	0	0	0
0	3	0	0	4	0	1	0	4	0	0	0	0	5	0	0	0	0	4	0	0	0	3	0	0	1	0	0	4	0	0	0
1	1	1	1	1	1	1	1	1	1	1	1	1	1	1	1	1	1	1	1	1	1	1	1	1	1	1	1	1	1	1	1
